%%%%%%%%%%%%%%%%%%%%%%%%%%%%%%%%
%                             P%
% %  %%%%%%%%%%%%%%%%%%%%%%%%%.%
% %                %.......%...%
% %    %%%%%%%%%%% %.%%%%%.%.%%%
% %%%% %           %...%...%...%
%   %    %%%%%%%%%%%%%.%.%%%%%.%
%               % .....%.......%
% %%%%%%%%%%%%%%%%.%%%%%%%%%%%%%
%                 .............%
%%%%%%%%%%%%%%%%%%%%%%%%%%%%%%%%
Nodes expanded: 79 Total Path Cost: 122
