%%%%%%%%%%%%%%%%%%%%%%%%%%%%%%%%
%..............................%
%.%  %%%%%%%%%%%%%%%%%%%%%%%%% %
%.%                %       %   %
%.%    %%%%%%%%%%% % %%%%% % %%%
%.%%%% %           %   %   %   %
%.  %    %%%%%%%%%%%%% % %%%%% %
%.              %      %       %
%.%%%%%%%%%%%%%%%% %%%%%%%%%%%%%
%..............................%
%%%%%%%%%%%%%%%%%%%%%%%%%%%%%%%%
Nodes expanded: 145 Total Path Cost: 71
